11368945,87,615,6750,0,528
11372987,615,1143,3150,0,528
11418804,4535,5351,2250,3101,816
11422523,5351,6167,11250,0,816
11425071,6167,7159,18000,0,992
11458874,1701,2345,4500,0,644
11458876,0,87,4500,0,87
11472003,2345,3075,2250,825,730
11485189,3075,3805,15750,0,730
11490013,1143,1701,11250,0,558
11490014,3805,4535,11250,0,730
