11368945,2805,3333,6750,0,528
11372987,1546,2074,3150,0,528
11418804,730,1546,2250,0,816
11422523,4621,5437,11250,0,816
11425071,6167,7159,18000,0,992
11458874,2161,2805,4500,0,644
11458876,2074,2161,4500,0,87
11472003,0,730,2250,0,730
11485189,5437,6167,15750,0,730
11490013,3333,3891,11250,0,558
11490014,3891,4621,11250,0,730
